NO mossy_cobble.xpm
SO nootnoot.xpm
WE brick.xpm
EA brick.xpm
S mossy_cobble.xpm

R 600 300
F 255,153,51
C 0,0,153

1111111111
10000000011111111
10000000000000001
1000S000000000001
10000000011111111
1000000001
1000020201
1010000001
1111111111
